Departamento,Municipio,total_obs,total_hab,votos_si,votos_no,votos_validos,votos_nomarcados,votos_nulos
AMAZONAS,EL ENCANTO,223,743,170,51,221,0,2
AMAZONAS,LA CHORRERA,366,1030,300,62,362,1,3
AMAZONAS,LA PEDRERA,216,1008,189,25,214,1,1
AMAZONAS,LA VICTORIA,5,18,4,1,5,0,0
AMAZONAS,LETICIA,8990,34592,4403,4463,8866,40,84
AMAZONAS,MIRITI PARANA,96,477,89,7,96,0,0
AMAZONAS,PUERTO ALEGRIA,59,259,52,5,57,1,1
AMAZONAS,PUERTO ARICA,119,405,97,22,119,0,0
AMAZONAS,PUERTO NARIÑO,1153,4317,830,274,1104,32,17
AMAZONAS,PUERTO SANTANDER,143,642,125,16,141,0,2
AMAZONAS,TARAPACA,344,1304,265,68,333,7,4
ANTIOQUIA,ABEJORRAL,3647,15274,1296,2105,3401,194,52
ANTIOQUIA,ABRIAQUI,572,1938,213,332,545,14,13
ANTIOQUIA,ALEJANDRIA,1735,4577,966,696,1662,51,22
ANTIOQUIA,AMAGA,6370,22028,2084,4139,6223,53,94
ANTIOQUIA,AMALFI,3818,16928,1310,2304,3614,132,72
ANTIOQUIA,ANDES,9093,34842,3193,5729,8922,78,93
ANTIOQUIA,ANGELOPOLIS,1589,5679,553,1004,1557,9,23
ANTIOQUIA,ANGOSTURA,1935,9154,705,1089,1794,57,84
ANTIOQUIA,ANORI,2984,11144,1764,953,2717,227,40
ANTIOQUIA,ANTIOQUIA,5495,19732,2041,3300,5341,52,102
ANTIOQUIA,ANZA,1150,5715,363,740,1103,31,16
ANTIOQUIA,APARTADO,27961,89196,14195,12936,27131,352,478
ANTIOQUIA,ARBOLETES,5866,21448,3691,1937,5628,181,57
ANTIOQUIA,ARGELIA,2065,6627,650,1351,2001,41,23
ANTIOQUIA,ARMENIA,1026,4844,301,676,977,23,26
ANTIOQUIA,BARBOSA,13430,38541,4200,8666,12866,287,277
ANTIOQUIA,BELLO,121850,318411,43642,76122,119764,509,1577
ANTIOQUIA,BELMIRA,1617,4807,687,897,1584,16,17
ANTIOQUIA,BETANIA,1609,8372,466,1110,1576,11,22
ANTIOQUIA,BETULIA,3023,13377,1005,1919,2924,50,49
ANTIOQUIA,BOLIVAR,5636,24029,1644,3875,5519,57,60
ANTIOQUIA,BRICEÑO,2078,6169,1367,604,1971,62,45
ANTIOQUIA,BURITICA,1406,6829,474,890,1364,22,20
ANTIOQUIA,CACERES,4004,19788,2506,1358,3864,57,83
ANTIOQUIA,CAICEDO,1600,6091,593,921,1514,43,43
ANTIOQUIA,CALDAS,25961,60580,9292,16149,25441,123,397
ANTIOQUIA,CAMPAMENTO,1296,6360,619,604,1223,32,41
ANTIOQUIA,CAÑASGORDAS,4884,13402,1911,2739,4650,113,121
ANTIOQUIA,CARACOLI,1199,4856,578,593,1171,16,12
ANTIOQUIA,CARAMANTA,1417,5231,568,790,1358,33,26
ANTIOQUIA,CAREPA,11733,41461,5327,6057,11384,159,190
ANTIOQUIA,CARMEN DE VIBORAL,16750,33070,5528,10787,16315,163,272
ANTIOQUIA,CAROLINA,1150,4081,464,641,1105,22,23
ANTIOQUIA,CAUCASIA,20911,66133,8801,11495,20296,247,368
ANTIOQUIA,CHIGORODO,12392,44791,6322,5745,12067,138,187
ANTIOQUIA,CISNEROS,3017,11434,1084,1837,2921,33,63
ANTIOQUIA,COCORNA,4864,12965,1647,3006,4653,130,81
ANTIOQUIA,CONCEPCION,1553,4409,572,931,1503,23,27
ANTIOQUIA,CONCORDIA,3184,16027,998,2081,3079,55,50
ANTIOQUIA,COPACABANA,25279,62062,9535,15052,24587,323,369
ANTIOQUIA,DABEIBA,4858,16986,2971,1622,4593,166,99
ANTIOQUIA,DON MATIAS,5381,16576,1371,3898,5269,41,71
ANTIOQUIA,EBEJICO,2846,11421,967,1788,2755,59,32
ANTIOQUIA,EL BAGRE,7520,36056,3167,4056,7223,141,156
ANTIOQUIA,ENTRERRIOS,2680,7957,868,1766,2634,16,30
ANTIOQUIA,ENVIGADO,106988,232003,37800,67255,105055,872,1061
ANTIOQUIA,FREDONIA,4858,18196,1703,3064,4767,27,64
ANTIOQUIA,FRONTINO,4038,16785,2148,1744,3892,68,78
ANTIOQUIA,GIRALDO,1251,3946,666,557,1223,11,17
ANTIOQUIA,GIRARDOTA,17135,47612,6088,10680,16768,90,277
ANTIOQUIA,GOMEZ PLATA,2192,8404,772,1328,2100,31,61
ANTIOQUIA,GRANADA,3630,10270,1382,2120,3502,75,53
ANTIOQUIA,GUADALUPE,1388,5656,714,587,1301,40,47
ANTIOQUIA,GUARNE,14804,31687,3870,10604,14474,116,214
ANTIOQUIA,GUATAPE,3261,6523,1232,1966,3198,26,37
ANTIOQUIA,HELICONIA,1492,6157,632,795,1427,36,29
ANTIOQUIA,HISPANIA,1142,5219,459,654,1113,18,11
ANTIOQUIA,ITAGUI,96563,245703,35166,59627,94793,426,1344
ANTIOQUIA,ITUANGO,4157,17406,2706,1196,3902,139,116
ANTIOQUIA,JARDIN,4594,12094,1620,2884,4504,46,44
ANTIOQUIA,JERICO,3373,11023,957,2341,3298,36,39
ANTIOQUIA,LA CEJA,22800,44306,6715,15589,22304,171,325
ANTIOQUIA,LA ESTRELLA,18723,50695,6725,11716,18441,88,194
ANTIOQUIA,LA PINTADA,2459,6588,1017,1389,2406,22,31
ANTIOQUIA,LA UNION,7529,16219,2551,4782,7333,60,136
ANTIOQUIA,LIBORINA,2703,9204,933,1674,2607,56,40
ANTIOQUIA,MACEO,1899,7467,777,1065,1842,31,26
ANTIOQUIA,MARINILLA,17767,38176,5481,11993,17474,103,190
ANTIOQUIA,MEDELLIN,694784,1508418,253548,431173,684721,3309,6754
ANTIOQUIA,MONTEBELLO,1827,6043,953,776,1729,63,35
ANTIOQUIA,MURINDO,1150,2724,1073,44,1117,19,14
ANTIOQUIA,MUTATA,3030,13626,1846,1016,2862,119,49
ANTIOQUIA,NARIÑO,2513,9015,786,1626,2412,70,31
ANTIOQUIA,NECHI,3834,18186,1937,1799,3736,41,57
ANTIOQUIA,NECOCLI,7475,32486,4359,2860,7219,101,155
ANTIOQUIA,OLAYA,740,2719,273,449,722,11,7
ANTIOQUIA,PEÑOL,5415,15806,2032,3265,5297,63,55
ANTIOQUIA,PEQUE,2331,6089,1632,608,2240,48,43
ANTIOQUIA,PUEBLORRICO,1787,7113,593,1138,1731,32,24
ANTIOQUIA,PUERTO BERRIO,9028,34085,2780,6046,8826,86,116
ANTIOQUIA,PUERTO NARE-LA MAGDALENA,3974,12202,2281,1600,3881,38,55
ANTIOQUIA,PUERTO TRIUNFO,3902,12982,1007,2823,3830,30,42
ANTIOQUIA,REMEDIOS,3579,17020,1186,2229,3415,38,126
ANTIOQUIA,RETIRO,6951,15100,2145,4703,6848,45,58
ANTIOQUIA,RIONEGRO,47791,94806,14361,32596,46957,197,637
ANTIOQUIA,SABANALARGA,2364,7052,778,1501,2279,44,41
ANTIOQUIA,SABANETA,27182,59616,9955,16903,26858,39,285
ANTIOQUIA,SALGAR,2474,13483,782,1621,2403,47,24
ANTIOQUIA,SAN ANDRES,1701,5184,706,864,1570,66,65
ANTIOQUIA,SAN CARLOS,5242,13944,2390,2697,5087,60,95
ANTIOQUIA,SAN FRANCISCO,1637,6140,660,901,1561,50,26
ANTIOQUIA,SAN JERONIMO,3475,11911,1260,2135,3395,39,41
ANTIOQUIA,SAN JOSE DE LA MONTAÑA,1032,3164,363,621,984,25,23
ANTIOQUIA,SAN JUAN DE URABA,4118,17433,2677,1365,4042,43,33
ANTIOQUIA,SAN LUIS,3644,10748,890,2681,3571,37,36
ANTIOQUIA,SAN PEDRO,7331,18915,1841,5334,7175,50,106
ANTIOQUIA,SAN PEDRO DE URABA,4146,25244,2060,1982,4042,42,62
ANTIOQUIA,SAN RAFAEL,4061,12155,1457,2295,3752,51,258
ANTIOQUIA,SAN ROQUE,4466,14580,1786,2548,4334,53,79
ANTIOQUIA,SAN VICENTE,6027,16445,1642,4238,5880,67,80
ANTIOQUIA,SANTA BARBARA,6063,22078,2101,3788,5889,67,107
ANTIOQUIA,SANTA ROSA DE OSOS,10280,25810,2984,6927,9911,90,279
ANTIOQUIA,SANTO DOMINGO,2929,9178,1085,1681,2766,56,107
ANTIOQUIA,SANTUARIO,12621,26217,3329,9020,12349,122,150
ANTIOQUIA,SEGOVIA,4684,26169,1516,3073,4589,27,68
ANTIOQUIA,SONSON,9293,27198,2319,6550,8869,158,266
ANTIOQUIA,SOPETRAN,4259,12063,1875,2266,4141,58,60
ANTIOQUIA,TAMESIS,4579,14473,1579,2889,4468,59,52
ANTIOQUIA,TARAZA,5988,26186,3477,2311,5788,90,110
ANTIOQUIA,TARSO,1230,5883,503,691,1194,22,14
ANTIOQUIA,TITIRIBI,2180,8726,742,1362,2104,37,39
ANTIOQUIA,TOLEDO,1429,4383,798,507,1305,61,63
ANTIOQUIA,TURBO,20913,84866,11378,8887,20265,277,371
ANTIOQUIA,URAMITA,1825,6351,951,813,1764,24,37
ANTIOQUIA,URRAO,5864,22361,2644,2959,5603,123,138
ANTIOQUIA,VALDIVIA,2261,12054,1072,1069,2141,63,57
ANTIOQUIA,VALPARAISO,1534,5665,597,893,1490,22,22
ANTIOQUIA,VEGACHI,1837,10165,503,1268,1771,44,22
ANTIOQUIA,VENECIA,2916,10977,1097,1767,2864,26,26
ANTIOQUIA,VIGIA DEL FUERTE,2187,5245,2079,86,2165,9,13
ANTIOQUIA,YALI,1160,6006,437,692,1129,25,6
ANTIOQUIA,YARUMAL,9483,33092,2941,6091,9032,264,187
ANTIOQUIA,YOLOMBO,3512,15878,1344,2055,3399,56,57
ANTIOQUIA,YONDO-CASABE,5376,12182,2376,2810,5186,62,128
ANTIOQUIA,ZARAGOZA,3545,18939,1672,1726,3398,59,88
ARAUCA,ARAUCA,23936,67929,8159,15191,23350,139,447
ARAUCA,ARAUQUITA,10113,27274,7440,2289,9729,150,234
ARAUCA,CRAVO NORTE,1103,3564,424,630,1054,11,38
ARAUCA,FORTUL,3646,10912,2338,1063,3401,58,187
ARAUCA,PUERTO RONDON,1131,3637,428,666,1094,18,19
ARAUCA,SARAVENA,10091,31702,4457,5168,9625,131,335
ARAUCA,TAME,11068,31607,5407,5267,10674,131,263
ATLANTICO,BARANOA,12549,45824,8936,3416,12352,139,58
ATLANTICO,BARRANQUILLA,256375,1029268,146039,108178,254217,1047,1111
ATLANTICO,CAMPO DE LA CRUZ,2812,19302,1728,1057,2785,13,14
ATLANTICO,CANDELARIA,3034,11294,2078,906,2984,25,25
ATLANTICO,GALAPA,8464,34607,5186,3176,8362,28,74
ATLANTICO,JUAN DE ACOSTA,3500,17179,2389,1082,3471,10,19
ATLANTICO,LURUACO,3564,23080,2265,1246,3511,28,25
ATLANTICO,MALAMBO,15857,74964,8810,6908,15718,45,94
ATLANTICO,MANATI,1995,13416,1660,317,1977,8,10
ATLANTICO,PALMAR DE VARELA,4265,19636,2871,1117,3988,255,22
ATLANTICO,PIOJO,1537,5409,1118,391,1509,13,15
ATLANTICO,POLONUEVO,3437,12246,2746,639,3385,23,29
ATLANTICO,PONEDERA,3909,17776,2445,1421,3866,23,20
ATLANTICO,PUERTO COLOMBIA,9330,31487,5701,3565,9266,26,38
ATLANTICO,REPELON,4213,18423,3325,829,4154,35,24
ATLANTICO,SABANAGRANDE,5132,22784,3251,1835,5086,17,29
ATLANTICO,SABANALARGA,18077,64908,12851,4663,17514,421,142
ATLANTICO,SANTA LUCIA,1969,9928,1467,481,1948,3,18
ATLANTICO,SANTO TOMAS,5743,25858,4088,1614,5702,17,24
ATLANTICO,SOLEDAD,57785,264289,33765,23487,57252,226,307
ATLANTICO,SUAN,2428,9555,1837,585,2422,3,3
ATLANTICO,TUBARA,2819,9481,1888,898,2786,17,16
ATLANTICO,USIACURI,2195,7497,1677,489,2166,14,15
BOGOTA D.C.,BOGOTA. D.C.,2570359,5547172,1423612,1114933,2538545,6601,25213
BOLIVAR,ACHI,6329,15748,4307,1874,6181,61,87
BOLIVAR,ALTOS DEL ROSARIO,1424,6667,786,601,1387,22,15
BOLIVAR,ARENAL,1950,5625,1690,229,1919,8,23
BOLIVAR,ARJONA,9785,51077,6030,3642,9672,50,63
BOLIVAR,ARROYO HONDO,1516,7362,1118,363,1481,28,7
BOLIVAR,BARRANCO DE LOBA,2830,11068,1465,1284,2749,59,22
BOLIVAR,CALAMAR,3715,17670,2140,1490,3630,48,37
BOLIVAR,CANTAGALLO,2671,6076,1878,732,2610,17,44
BOLIVAR,CARTAGENA,147441,732774,81500,64735,146235,688,518
BOLIVAR,CICUCO,2988,9346,2082,856,2938,29,21
BOLIVAR,CLEMENCIA,1772,10304,1146,590,1736,19,17
BOLIVAR,CORDOBA,4722,13053,3612,1001,4613,66,43
BOLIVAR,EL CARMEN DE BOLIVAR,15922,53418,8287,7290,15577,129,216
BOLIVAR,EL GUAMO,2017,7284,1578,405,1983,23,11
BOLIVAR,EL PEÑON,1519,5820,911,574,1485,19,15
BOLIVAR,HATILLO DE LOBA,2648,9848,1322,1285,2607,16,25
BOLIVAR,MAGANGUE,26911,93554,16478,9966,26444,206,261
BOLIVAR,MAHATES,4121,19421,2819,1222,4041,48,32
BOLIVAR,MARGARITA,2326,8814,1361,919,2280,33,13
BOLIVAR,MARIA LA BAJA,8940,37800,7009,1761,8770,97,73
BOLIVAR,MOMPOS,8361,34934,5198,3036,8234,59,68
BOLIVAR,MONTECRISTO,2099,8357,1652,395,2047,35,17
BOLIVAR,MORALES,4215,10842,1936,2206,4142,34,39
BOLIVAR,NOROSI,1169,3698,969,177,1146,9,14
BOLIVAR,PINILLOS,4948,16205,2973,1885,4858,49,41
BOLIVAR,REGIDOR,1437,4492,1092,323,1415,4,18
BOLIVAR,RIOVIEJO,2177,5875,1488,639,2127,20,30
BOLIVAR,SAN CRISTOBAL,1893,6462,1630,249,1879,6,8
BOLIVAR,SAN ESTANISLAO,2804,14001,1900,869,2769,16,19
BOLIVAR,SAN FERNANDO,2409,7937,1949,428,2377,17,15
BOLIVAR,SAN JACINTO,6348,20212,3736,2477,6213,73,62
BOLIVAR,SAN JACINTO DEL CAUCA,2039,6809,1389,612,2001,20,18
BOLIVAR,SAN JUAN NEPOMUCENO,8618,30146,5134,3287,8421,86,111
BOLIVAR,SAN MARTIN DE LOBA,2841,10724,1943,856,2799,20,22
BOLIVAR,SAN PABLO,5958,17280,2802,2940,5742,122,94
BOLIVAR,SANTA CATALINA,2448,11565,1759,553,2312,17,119
BOLIVAR,SANTA ROSA,1771,13161,1129,609,1738,9,24
BOLIVAR,SANTA ROSA DEL SUR,7238,19146,2648,4421,7069,57,112
BOLIVAR,SIMITI,3652,11953,1753,1783,3536,43,73
BOLIVAR,SOPLAVIENTO,2242,7990,1888,324,2212,10,20
BOLIVAR,TALAIGUA NUEVO,2968,8861,1870,1045,2915,37,16
BOLIVAR,TIQUISIO (PTO. RICO),3108,12563,1686,1366,3052,34,22
BOLIVAR,TURBACO,9954,58808,5927,3957,9884,29,41
BOLIVAR,TURBANA,2543,13769,1728,781,2509,17,17
BOLIVAR,VILLANUEVA,1974,15014,1181,763,1944,16,14
BOLIVAR,ZAMBRANO,3727,8695,3140,507,3647,34,46
BOYACA,ALMEIDA,693,1908,348,327,675,7,11
BOYACA,AQUITANIA (PUEBLOVIEJO),4299,12347,1208,2985,4193,41,65
BOYACA,ARCABUCO,1718,4570,773,882,1655,9,54
BOYACA,BELEN,2602,6748,1150,1344,2494,27,81
BOYACA,BERBEO,588,1465,387,181,568,5,15
BOYACA,BETEITIVA,685,1915,407,252,659,7,19
BOYACA,BOAVITA,1866,5162,798,1002,1800,26,40
BOYACA,BOYACA,1073,4201,601,432,1033,16,24
BOYACA,BRICEÑO,772,2098,471,282,753,12,7
BOYACA,BUENAVISTA,1460,4573,616,790,1406,25,29
BOYACA,BUSBANZA,370,794,174,183,357,6,7
BOYACA,CALDAS,1139,3278,651,453,1104,11,24
BOYACA,CAMPOHERMOSO,977,2508,507,432,939,15,23
BOYACA,CERINZA,1628,3482,961,595,1556,18,54
BOYACA,CHINAVITA,942,3131,421,497,918,7,17
BOYACA,CHIQUINQUIRA,17119,40893,8110,8619,16729,87,303
BOYACA,CHIQUIZA,912,4330,537,330,867,18,27
BOYACA,CHISCAS,1405,3519,672,658,1330,35,40
BOYACA,CHITA,2319,6331,861,1294,2155,89,75
BOYACA,CHITARAQUE,1654,5445,644,962,1606,29,19
BOYACA,CHIVATA,930,2542,477,439,916,7,7
BOYACA,CHIVOR,656,1769,260,378,638,10,8
BOYACA,CIENEGA,1233,3872,543,655,1198,19,16
BOYACA,COMBITA,3653,8585,2081,1452,3533,34,86
BOYACA,COPER,1332,3278,779,521,1300,13,19
BOYACA,CORRALES,955,2228,408,511,919,14,22
BOYACA,COVARACHIA,1080,3133,394,626,1020,44,16
BOYACA,CUBARA,1469,5484,781,597,1378,23,68
BOYACA,CUCAITA,1264,3186,683,543,1226,8,30
BOYACA,CUITIVA,653,1851,269,363,632,2,19
BOYACA,DUITAMA,41211,83354,19535,20787,40322,119,770
BOYACA,EL COCUY,1282,3716,374,830,1204,30,48
BOYACA,EL ESPINO,997,2301,339,627,966,11,20
BOYACA,FIRAVITOBA,2129,5680,1317,758,2075,17,37
BOYACA,FLORESTA,1354,3078,527,799,1326,8,20
BOYACA,GACHANTIVA,1342,3020,621,678,1299,19,24
BOYACA,GAMEZA,1491,4056,621,825,1446,22,23
BOYACA,GARAGOA,5174,11845,2534,2485,5019,36,119
BOYACA,GUACAMAYAS,631,1656,122,479,601,11,19
BOYACA,GUATEQUE,3421,8954,1718,1599,3317,24,80
BOYACA,GUAYATA,1530,3849,861,633,1494,14,22
BOYACA,GUICAN,1204,3033,556,592,1148,14,42
BOYACA,IZA,857,2224,367,465,832,12,13
BOYACA,JENESANO,1673,5464,1031,584,1615,25,33
BOYACA,JERICO,974,3218,359,570,929,22,23
BOYACA,LA CAPILLA,1072,2576,525,493,1018,26,28
BOYACA,LA UVITA,933,2537,287,611,898,16,19
BOYACA,LA VICTORIA,573,1513,417,136,553,11,9
BOYACA,LABRANZAGRANDE,1003,2722,444,529,973,13,17
BOYACA,MACANAL,1235,3603,464,728,1192,19,24
BOYACA,MARIPI,1871,6271,1371,459,1830,16,25
BOYACA,MIRAFLORES,3688,7568,2330,1233,3563,44,81
BOYACA,MONGUA,1686,4003,397,1258,1655,6,25
BOYACA,MONGUI,1434,3643,530,870,1400,5,29
BOYACA,MONIQUIRA,6492,17452,3257,3016,6273,57,162
BOYACA,MOTAVITA,1846,4938,955,836,1791,14,41
BOYACA,MUZO,2420,7195,858,1470,2328,37,55
BOYACA,NOBSA,5741,11546,2835,2809,5644,11,86
BOYACA,NUEVO COLON,1794,4608,1107,624,1731,17,46
BOYACA,OICATA,1135,2392,605,492,1097,8,30
BOYACA,OTANCHE,2369,6406,1021,1297,2318,23,28
BOYACA,PACHAVITA,779,2001,370,374,744,20,15
BOYACA,PAEZ,1228,2338,558,613,1171,14,43
BOYACA,PAIPA,11312,24543,6187,4866,11053,59,200
BOYACA,PAJARITO,650,1713,234,399,633,8,9
BOYACA,PANQUEBA,649,1605,285,335,620,14,15
BOYACA,PAUNA,2401,6712,1521,802,2323,37,41
BOYACA,PAYA,737,1406,320,383,703,8,26
BOYACA,PAZ DE RIO,1741,4373,1119,566,1685,18,38
BOYACA,PESCA,1819,6418,710,1061,1771,15,33
BOYACA,PISBA,463,1021,195,256,451,9,3
BOYACA,PUERTO BOYACA,14347,35230,4270,9611,13881,127,339
BOYACA,QUIPAMA,1768,4928,637,1066,1703,33,32
BOYACA,RAMIRIQUI,2789,8601,1466,1267,2733,22,34
BOYACA,RAQUIRA,1730,4570,815,851,1666,20,44
BOYACA,RONDON,929,2283,469,426,895,17,17
BOYACA,SABOYA,3664,9555,2246,1250,3496,56,112
BOYACA,SACHICA,1350,3320,702,624,1326,11,13
BOYACA,SAMACA,4849,13405,2343,2340,4683,36,130
BOYACA,SAN EDUARDO,711,1463,434,245,679,10,22
BOYACA,SAN JOSE DE PARE,1838,5295,946,844,1790,28,20
BOYACA,SAN LUIS DE GACENO,1779,4488,628,1111,1739,18,22
BOYACA,SAN MATEO,1147,3636,368,720,1088,29,30
BOYACA,SAN MIGUEL DE SEMA,1101,2760,513,550,1063,17,21
BOYACA,SAN PABLO DE BORBUR,1890,5810,584,1246,1830,31,29
BOYACA,SANTA MARIA,1137,3309,433,656,1089,18,30
BOYACA,SANTA ROSA DE VITERBO,3726,8045,1553,2073,3626,28,72
BOYACA,SANTA SOFIA,1084,3068,648,399,1047,16,21
BOYACA,SANTANA,2198,6831,1106,1034,2140,24,34
BOYACA,SATIVANORTE,773,2398,373,362,735,15,23
BOYACA,SATIVASUR,377,1227,197,174,371,2,4
BOYACA,SIACHOQUE,2310,6256,778,1453,2231,25,54
BOYACA,SOATA,3543,7449,1461,1989,3450,37,56
BOYACA,SOCHA,2395,6151,1138,1160,2298,33,64
BOYACA,SOCOTA,2104,5922,791,1214,2005,39,60
BOYACA,SOGAMOSO,41974,89443,20261,20865,41126,148,700
BOYACA,SOMONDOCO,895,2779,529,344,873,8,14
BOYACA,SORA,1319,2528,686,459,1145,152,22
BOYACA,SORACA,2273,5229,740,1489,2229,20,24
BOYACA,SOTAQUIRA,2070,5413,1039,978,2017,14,39
BOYACA,SUSACON,1166,2580,701,410,1111,19,36
BOYACA,SUTAMARCHAN,2119,5264,1132,931,2063,18,38
BOYACA,SUTATENZA,1318,3682,612,662,1274,14,30
BOYACA,TASCO,1598,4986,913,641,1554,7,37
BOYACA,TENZA,1663,3555,1028,592,1620,17,26
BOYACA,TIBANA,2123,7402,1312,740,2052,14,57
BOYACA,TIBASOSA,3615,8412,1842,1685,3527,13,75
BOYACA,TINJACA,1162,2538,632,505,1137,5,20
BOYACA,TIPACOQUE,1136,3353,557,520,1077,30,29
BOYACA,TOCA,2344,6996,1107,1168,2275,29,40
BOYACA,TOGUI,967,4284,516,410,926,19,22
BOYACA,TOPAGA,1370,2924,552,789,1341,10,19
BOYACA,TOTA,943,4105,318,590,908,10,25
BOYACA,TUNJA,59038,116576,32780,25112,57892,143,1003
BOYACA,TUNUNGUA,655,1314,461,181,642,4,9
BOYACA,TURMEQUE,1786,5703,1161,568,1729,16,41
BOYACA,TUTA,3113,7216,1536,1497,3033,23,57
BOYACA,TUTAZA,949,1841,492,412,904,16,29
BOYACA,UMBITA,2281,5815,980,1224,2204,30,47
BOYACA,VENTAQUEMADA,3354,10912,1566,1689,3255,18,81
BOYACA,VILLA DE LEIVA,4877,10171,2479,2307,4786,25,66
BOYACA,VIRACACHA,822,2553,343,452,795,11,16
BOYACA,ZETAQUIRA,1410,3874,910,473,1383,12,15
CALDAS,AGUADAS,7035,18854,1961,4766,6727,134,174
CALDAS,ANSERMA,11209,27896,3356,7430,10786,153,270
CALDAS,ARANZAZU,4191,11540,1573,2409,3982,86,123
CALDAS,BELALCAZAR,3890,10118,1514,2105,3619,219,52
CALDAS,CHINCHINA,17205,43763,6185,10543,16728,162,315
CALDAS,FILADELFIA,3281,9343,1365,1783,3148,71,62
CALDAS,LA DORADA,21133,57740,6908,13558,20466,122,545
CALDAS,LA MERCED,2067,5641,866,1108,1974,43,50
CALDAS,MANIZALES,154340,323102,74140,76961,151101,734,2505
CALDAS,MANZANARES,5092,15465,1773,3146,4919,82,91
CALDAS,MARMATO,1711,6840,514,1133,1647,23,41
CALDAS,MARQUETALIA,4073,11445,1452,2427,3879,101,93
CALDAS,MARULANDA,831,2658,387,391,778,21,32
CALDAS,NEIRA,6743,19307,2283,4191,6474,101,168
CALDAS,NORCASIA,2172,5865,906,1179,2085,36,51
CALDAS,PACORA,4413,12064,1548,2727,4275,62,76
CALDAS,PALESTINA,4465,14755,1867,2513,4380,34,51
CALDAS,PENSILVANIA,6228,16734,1880,3959,5839,198,191
CALDAS,RIOSUCIO,15076,37633,6070,8402,14472,205,399
CALDAS,RISARALDA,3064,10761,959,2021,2980,35,49
CALDAS,SALAMINA,5376,15660,2096,3021,5117,173,86
CALDAS,SAMANA,6692,16191,2814,3513,6327,156,209
CALDAS,SAN JOSE,1491,4918,623,817,1440,21,30
CALDAS,SUPIA,7883,21254,2408,4985,7393,141,349
CALDAS,VICTORIA,3079,8262,1249,1735,2984,44,51
CALDAS,VILLAMARIA,17736,37945,7470,9806,17276,130,330
CALDAS,VITERBO,5204,12839,1373,3737,5110,38,56
CAQUETA,ALBANIA,1430,3923,445,842,1287,121,22
CAQUETA,BELEN DE LOS ANDAQUIES,2600,7573,1001,1504,2505,36,59
CAQUETA,CARTAGENA DEL CHAIRA,4927,18805,3530,1256,4786,60,81
CAQUETA,CURILLO,1871,7604,729,1052,1781,35,55
CAQUETA,EL DONCELLO,4230,15558,1593,2511,4104,37,89
CAQUETA,EL PAUJIL,2683,11865,1157,1439,2596,35,52
CAQUETA,FLORENCIA,39004,115892,14803,23593,38396,187,421
CAQUETA,LA MONTAÑITA,3136,10500,2295,797,3092,21,23
CAQUETA,MILAN,1369,6861,750,590,1340,9,20
CAQUETA,MORELIA,1143,3584,387,731,1118,9,16
CAQUETA,PUERTO RICO,5470,18802,2643,2645,5288,78,104
CAQUETA,SAN JOSE DEL FRAGUA,2894,8875,1116,1699,2815,24,55
CAQUETA,SAN VICENTE DEL CAGUAN,9786,31524,6034,3554,9588,87,111
CAQUETA,SOLANO,2004,7754,1506,460,1966,18,20
CAQUETA,SOLITA,1332,5746,484,804,1288,18,26
CAQUETA,VALPARAISO,1611,6188,724,805,1529,22,60
CASANARE,AGUAZUL,14484,26606,4123,9666,13789,96,599
CASANARE,CHAMEZA,968,1551,663,271,934,9,25
CASANARE,HATO COROZAL,2825,6995,591,2133,2724,40,61
CASANARE,LA SALINA,458,762,391,51,442,5,11
CASANARE,MANI,4850,10075,1459,3265,4724,40,86
CASANARE,MONTERREY,5762,11103,1639,3998,5637,38,87
CASANARE,NUNCHIA,2959,6023,579,2272,2851,41,67
CASANARE,OROCUE,3073,7605,1182,1800,2982,30,61
CASANARE,PAZ DE ARIPORO (MORENO),9932,23027,2243,7379,9622,100,210
CASANARE,PORE,3471,6622,662,2684,3346,34,91
CASANARE,RECETOR,705,1260,337,305,642,20,43
CASANARE,SABANALARGA,1387,2758,680,664,1344,13,30
CASANARE,SACAMA,751,1537,563,97,660,14,77
CASANARE,SAN LUIS DE PALENQUE,2616,5886,548,1988,2536,28,52
CASANARE,TAMARA,1965,4325,528,1350,1878,45,42
CASANARE,TAURAMENA,8445,15751,2209,6037,8246,60,139
CASANARE,TRINIDAD,3830,9211,735,2966,3701,42,87
CASANARE,VILLANUEVA,8282,19519,2425,5625,8050,59,173
CASANARE,YOPAL,52151,102568,14561,36503,51064,229,858
CAUCA,ALMAGUER,3698,12511,2874,570,3444,85,169
CAUCA,ARGELIA,6830,17783,5807,751,6558,97,175
CAUCA,BALBOA,5389,15693,4425,731,5156,107,126
CAUCA,BOLIVAR,8455,31054,5234,2772,8006,163,286
CAUCA,BUENOS AIRES,6698,15556,4594,1773,6367,143,188
CAUCA,CAJIBIO,7230,23310,4922,2002,6924,168,138
CAUCA,CALDONO,8943,20628,6792,1715,8507,169,267
CAUCA,CALOTO,8294,17687,5875,2183,8058,70,166
CAUCA,CORINTO,8489,17445,5669,2520,8189,113,187
CAUCA,EL TAMBO,11938,34429,6595,4616,11211,368,359
CAUCA,FLORENCIA,2151,4576,1530,520,2050,37,64
CAUCA,GUACHENE,6090,12259,4160,1663,5823,65,202
CAUCA,GUAPI,6172,19182,5596,415,6011,83,78
CAUCA,INZA,4649,16634,3318,1177,4495,80,74
CAUCA,JAMBALO,3945,8072,3270,520,3790,66,89
CAUCA,LA SIERRA,2955,8829,1714,1109,2823,69,63
CAUCA,LA VEGA,5264,15137,3840,1121,4961,175,128
CAUCA,LOPEZ (MICAY),4282,12401,3980,265,4245,25,12
CAUCA,MERCADERES,4271,13882,3135,960,4095,99,77
CAUCA,MIRANDA,9536,18593,5933,3379,9312,58,166
CAUCA,MORALES,6612,18642,3764,2412,6176,211,225
CAUCA,PADILLA,3149,6631,2258,752,3010,35,104
CAUCA,PAEZ (BELALCAZAR),6887,19497,4692,1801,6493,240,154
CAUCA,PATIA (EL BORDO),8223,25540,5770,2233,8003,108,112
CAUCA,PIAMONTE,1548,5010,996,492,1488,29,31
CAUCA,PIENDAMO,9382,26554,4840,4240,9080,153,149
CAUCA,POPAYAN,95678,225161,55296,38628,93924,525,1229
CAUCA,PUERTO TEJADA,13063,32002,8482,4123,12605,124,334
CAUCA,PURACE (COCONUCO),2386,8676,1458,822,2280,52,54
CAUCA,ROSAS,3178,8645,1794,1211,3005,83,90
CAUCA,SAN SEBASTIAN,2684,7156,1991,530,2521,93,70
CAUCA,SANTA ROSA,1268,4092,787,421,1208,28,32
CAUCA,SANTANDER DE QUILICHAO,29726,73826,16723,12224,28947,210,569
CAUCA,SILVIA,7980,21970,5792,1804,7596,191,193
CAUCA,SOTARA (PAISPAMBA),3143,7302,2010,927,2937,123,83
CAUCA,SUAREZ,6160,15860,3890,1912,5802,143,215
CAUCA,SUCRE,1790,5460,1418,304,1722,37,31
CAUCA,TIMBIO,9414,24676,5047,4057,9104,119,191
CAUCA,TIMBIQUI,6348,14326,5885,370,6255,29,64
CAUCA,TORIBIO,8220,16666,6535,1171,7706,349,165
CAUCA,TOTORO,3603,10804,2615,884,3499,47,57
CAUCA,VILLA RICA,5856,13241,3913,1696,5609,41,206
CESAR,AGUACHICA,27136,65630,8179,18389,26568,138,430
CESAR,AGUSTIN CODAZZI,13211,45542,6261,6681,12942,106,163
CESAR,ASTREA,3873,14110,2004,1793,3797,36,40
CESAR,BECERRIL,4642,14502,2753,1787,4540,44,58
CESAR,BOSCONIA,8781,26471,4979,3593,8572,100,109
CESAR,CHIMICHAGUA,6286,23597,3327,2834,6161,30,95
CESAR,CHIRIGUANA,6698,20688,3850,2666,6516,85,97
CESAR,CURUMANI,7411,24745,4286,2952,7238,64,109
CESAR,EL COPEY,5934,22065,3761,2061,5822,35,77
CESAR,EL PASO,6462,19849,4073,2292,6365,29,68
CESAR,GAMARRA,3438,10255,1609,1777,3386,26,26
CESAR,GONZALEZ,1237,3867,608,560,1168,25,44
CESAR,LA GLORIA,3742,10450,1881,1776,3657,31,54
CESAR,LA JAGUA DE IBIRICO,9694,24815,5096,4321,9417,58,219
CESAR,LA PAZ,6198,18777,3528,2583,6111,22,65
CESAR,MANAURE BALCON DEL CESAR (MANA,3187,7225,1913,1206,3119,22,46
CESAR,PAILITAS,5023,14163,2874,1943,4817,57,149
CESAR,PELAYA,4794,13460,2222,2410,4632,56,106
CESAR,PUEBLO BELLO,2558,16511,1706,785,2491,30,37
CESAR,RIO DE ORO,4535,14285,1605,2695,4300,172,63
CESAR,SAN ALBERTO,6734,18215,2496,4100,6596,39,99
CESAR,SAN DIEGO,5004,14089,3003,1884,4887,42,75
CESAR,SAN MARTIN,5698,14366,1934,3623,5557,30,111
CESAR,TAMALAMEQUE,2838,10017,1859,892,2751,27,60
CESAR,VALLEDUPAR,87908,279165,44788,41843,86631,379,898
CHOCO,ACANDI,2105,8345,1568,485,2053,33,19
CHOCO,ALTO BAUDO (PIE DE PATO),3217,9515,2942,234,3176,22,19
CHOCO,ATRATO (YUTO),2675,8224,2080,504,2584,31,60
CHOCO,BAGADO,2518,8376,2264,196,2460,12,46
CHOCO,BAHIA SOLANO (MUTIS),2350,7582,1917,389,2306,24,20
CHOCO,BAJO BAUDO (PIZARRO),3038,10197,2741,233,2974,43,21
CHOCO,BOJAYA (BELLAVISTA),2086,6868,1978,87,2065,6,15
CHOCO,CARMEN DEL DARIEN,1368,5537,1290,58,1348,12,8
CHOCO,CERTEGUI,1709,4109,1238,382,1620,2,87
CHOCO,CONDOTO,3344,10526,2296,863,3159,45,140
CHOCO,EL CANTON DEL SAN PABLO (MAN.,1281,4495,916,307,1223,22,36
CHOCO,EL CARMEN,1903,5918,1033,799,1832,25,46
CHOCO,EL LITORAL DEL SAN JUAN,2811,7257,2508,135,2643,156,12
CHOCO,ISTMINA,5912,21319,3990,1679,5669,88,155
CHOCO,JURADO,744,3049,580,144,724,13,7
CHOCO,LLORO,2666,7605,2128,435,2563,40,63
CHOCO,MEDIO ATRATO (BETE),2252,5663,2145,93,2238,6,8
CHOCO,MEDIO BAUDO (PUERTO MELUK),2787,7639,2561,187,2748,16,23
CHOCO,MEDIO SAN JUAN,3081,7475,2580,411,2991,36,54
CHOCO,NOVITA,1739,5232,1212,423,1635,30,74
CHOCO,NUQUI,1543,5413,1416,103,1519,12,12
CHOCO,QUIBDO,28522,80380,20260,7159,27419,308,795
CHOCO,RIO IRO,1340,3839,1185,115,1300,13,27
CHOCO,RIO QUITO (PAIMADO),2592,6144,1965,578,2543,15,34
CHOCO,RIOSUCIO,3879,13524,3462,345,3807,36,36
CHOCO,SAN JOSE DEL PALMAR,1101,4157,724,308,1032,22,47
CHOCO,SIPI,749,2467,618,88,706,17,26
CHOCO,TADO,4281,12777,2830,1238,4068,56,157
CHOCO,UNGUIA,2204,8348,1426,736,2162,26,16
CHOCO,UNION PANAMERICANA (LAS ANIMAS,1852,5046,1404,381,1785,26,41
CONSULADOS,ALEMANIA,564,2942,488,75,563,0,1
CONSULADOS,ANTIGUA Y BARBUDA,0,8,0,0,0,0,0
CONSULADOS,ARGENTINA,1396,6040,1166,226,1392,2,2
CONSULADOS,ARUBA,656,3024,228,426,654,1,1
CONSULADOS,AUSTRALIA,975,3843,695,280,975,0,0
CONSULADOS,AUSTRIA,168,518,139,29,168,0,0
CONSULADOS,BELGICA,386,1487,314,71,385,1,0
CONSULADOS,BOLIVIA,127,726,67,60,127,0,0
CONSULADOS,BRASIL,476,2029,388,86,474,0,2
CONSULADOS,CANADA,4283,17355,2717,1559,4276,1,6
CONSULADOS,CHILE,1302,5228,879,421,1300,1,1
CONSULADOS,CHINA REPUBLICA POPULAR,78,430,68,10,78,0,0
CONSULADOS,CHIPRE,24,41,13,10,23,0,1
CONSULADOS,COREA DEL SUR,22,100,20,2,22,0,0
CONSULADOS,COSTA RICA,1661,7700,825,832,1657,0,4
CONSULADOS,CUBA,17,188,16,1,17,0,0
CONSULADOS,CURAZAO,233,1321,89,142,231,0,2
CONSULADOS,DINAMARCA,29,57,28,1,29,0,0
CONSULADOS,ECUADOR,2700,23212,1686,991,2677,10,13
CONSULADOS,EGIPTO,16,144,14,2,16,0,0
CONSULADOS,EL SALVADOR,133,472,66,67,133,0,0
CONSULADOS,EMIRATOS ARABES UNIDOS,281,776,63,217,280,0,1
CONSULADOS,ESPAÑA,7138,85658,4891,2235,7126,8,4
CONSULADOS,ESTADOS UNIDOS,34205,191606,12816,21347,34163,9,33
CONSULADOS,FILIPINAS,16,66,12,4,16,0,0
CONSULADOS,FINLANDIA,39,70,33,6,39,0,0
CONSULADOS,FRANCIA,1816,7110,1498,317,1815,1,0
CONSULADOS,GHANA,5,17,5,0,5,0,0
CONSULADOS,GRECIA,23,47,19,4,23,0,0
CONSULADOS,GUATEMALA,215,724,109,106,215,0,0
CONSULADOS,HOLANDA,301,1693,233,68,301,0,0
CONSULADOS,HONDURAS,61,441,34,27,61,0,0
CONSULADOS,INDIA,14,79,14,0,14,0,0
CONSULADOS,INDONESIA,56,190,47,9,56,0,0
CONSULADOS,INGLATERRA,1694,9177,1159,532,1691,1,2
CONSULADOS,IRLANDA,49,91,33,16,49,0,0
CONSULADOS,ISRAEL,62,774,39,22,61,0,1
CONSULADOS,ITALIA,431,5241,321,107,428,1,2
CONSULADOS,JAMAICA,32,256,14,18,32,0,0
CONSULADOS,JAPON,112,799,79,33,112,0,0
CONSULADOS,KENIA,15,57,13,2,15,0,0
CONSULADOS,LIBANO,46,739,34,12,46,0,0
CONSULADOS,MALASIA,20,105,13,7,20,0,0
CONSULADOS,MARRUECOS,6,16,6,0,6,0,0
CONSULADOS,MEXICO,1079,4304,742,337,1079,0,0
CONSULADOS,NICARAGUA,61,226,48,13,61,0,0
CONSULADOS,NORUEGA,27,108,26,1,27,0,0
CONSULADOS,NUEVA ZELANDIA,83,182,59,24,83,0,0
CONSULADOS,PANAMA,1491,11757,704,783,1487,1,3
CONSULADOS,PARAGUAY,70,261,34,36,70,0,0
CONSULADOS,PERU,689,2755,449,239,688,0,1
CONSULADOS,POLONIA,26,114,21,5,26,0,0
CONSULADOS,PORTUGAL,73,353,58,15,73,0,0
CONSULADOS,PUERTO RICO,248,1167,148,100,248,0,0
CONSULADOS,REPUBLICA DOMINICANA,512,1741,294,218,512,0,0
CONSULADOS,RUSIA,34,304,31,3,34,0,0
CONSULADOS,SUDAFRICA,63,184,41,21,62,0,1
CONSULADOS,SUECIA,273,1267,216,57,273,0,0
CONSULADOS,SUIZA,656,2724,514,142,656,0,0
CONSULADOS,TAILANDIA,15,52,13,2,15,0,0
CONSULADOS,TRINIDAD Y TOBAGO,24,117,13,11,24,0,0
CONSULADOS,TURQUIA,26,70,20,6,26,0,0
CONSULADOS,URUGUAY,100,391,76,23,99,0,1
CONSULADOS,VENEZUELA,15563,188352,9903,5539,15442,45,76
CORDOBA,AYAPEL,7217,32199,4178,2882,7060,76,81
CORDOBA,BUENAVISTA,5696,17581,4048,1541,5589,46,61
CORDOBA,CANALETE,3468,16098,2640,777,3417,31,20
CORDOBA,CERETE,23285,71178,11746,11179,22925,104,256
CORDOBA,CHIMA,3970,12752,2825,1091,3916,27,27
CORDOBA,CHINU,13226,35501,6434,6345,12779,273,174
CORDOBA,CIENAGA DE ORO,15211,42082,9377,5504,14881,142,188
CORDOBA,COTORRA (BONGO),4112,13988,2636,1387,4023,30,59
CORDOBA,LA APARTADA (FRONTERA),3919,12522,2537,1217,3754,100,65
CORDOBA,LORICA,26378,84539,17559,8386,25945,167,266
CORDOBA,LOS CORDOBAS,4841,13721,3695,1057,4752,50,39
CORDOBA,MOMIL,4220,12929,2830,1340,4170,25,25
CORDOBA,MONTELIBANO,18769,55017,10631,7643,18274,155,340
CORDOBA,MONTERIA,93265,302825,44207,47850,92057,427,781
CORDOBA,MOÑITOS,5436,18119,4230,1090,5320,51,65
CORDOBA,PLANETA RICA,15294,53300,8676,6244,14920,128,246
CORDOBA,PUEBLO NUEVO,7487,23411,4882,2428,7310,85,92
CORDOBA,PUERTO ESCONDIDO,5459,17941,4000,1170,5170,229,60
CORDOBA,PUERTO LIBERTADOR,10422,25885,7691,2439,10130,113,179
CORDOBA,PURISIMA,3904,13416,1972,1778,3750,116,38
CORDOBA,SAHAGUN,26824,78125,16501,9762,26263,277,284
CORDOBA,SAN ANDRES DE SOTAVENTO,10741,27627,7633,2826,10459,148,134
CORDOBA,SAN ANTERO,7080,20685,4352,2605,6957,35,88
CORDOBA,SAN BERNARDO DEL VIENTO,7351,26348,5799,1434,7233,61,57
CORDOBA,SAN CARLOS,3722,19707,2150,1511,3661,25,36
CORDOBA,SAN JOSE DE URE,2783,7141,2198,516,2714,26,43
CORDOBA,SAN PELAYO,11165,35301,7363,3601,10964,60,141
CORDOBA,TIERRALTA,18665,60877,12579,5452,18031,323,311
CORDOBA,TUCHIN,8218,21288,5273,2467,7740,281,197
CORDOBA,VALENCIA,6851,25119,4581,2089,6670,90,91
CUNDINAMARCA,AGUA DE DIOS,3903,9742,1723,2117,3840,25,38
CUNDINAMARCA,ALBAN,1820,5069,693,1086,1779,8,33
CUNDINAMARCA,ANAPOIMA,4531,11225,2008,2466,4474,17,40
CUNDINAMARCA,ANOLAIMA,4241,11234,1698,2461,4159,36,46
CUNDINAMARCA,APULO,2689,6824,1323,1315,2638,16,35
CUNDINAMARCA,ARBELAEZ,3916,8852,1496,2349,3845,26,45
CUNDINAMARCA,BELTRAN,661,1987,321,325,646,9,6
CUNDINAMARCA,BITUIMA,871,2823,454,396,850,13,8
CUNDINAMARCA,BOJACA,3208,5893,1241,1875,3116,16,76
CUNDINAMARCA,CABRERA,1435,3457,991,346,1337,19,79
CUNDINAMARCA,CACHIPAY,3505,8749,1686,1756,3442,22,41
CUNDINAMARCA,CAJICA,20062,38304,9016,10722,19738,49,275
CUNDINAMARCA,CAPARRAPI,3377,10164,1170,2076,3246,57,74
CUNDINAMARCA,CAQUEZA,5525,14339,2001,3393,5394,22,109
CUNDINAMARCA,CARMEN DE CARUPA,2120,6176,780,1287,2067,12,41
CUNDINAMARCA,CHAGUANI,1503,3664,740,721,1461,23,19
CUNDINAMARCA,CHIA,43940,83132,21717,21715,43432,84,424
CUNDINAMARCA,CHIPAQUE,2928,7434,892,1985,2877,8,43
CUNDINAMARCA,CHOACHI,4713,11254,1573,3042,4615,28,70
CUNDINAMARCA,CHOCONTA,5774,14326,2041,3578,5619,45,110
CUNDINAMARCA,COGUA,6766,12927,2684,3935,6619,19,128
CUNDINAMARCA,COTA,10096,22995,4585,5388,9973,25,98
CUNDINAMARCA,CUCUNUBA,2161,4708,728,1371,2099,13,49
CUNDINAMARCA,EL COLEGIO,7252,19138,3186,3938,7124,46,82
CUNDINAMARCA,EL PEÑON,1376,4351,521,809,1330,29,17
CUNDINAMARCA,EL ROSAL,7909,13750,2479,5218,7697,41,171
CUNDINAMARCA,FACATATIVA,46982,87088,18839,26978,45817,109,1056
CUNDINAMARCA,FOMEQUE,3966,9437,1126,2777,3903,25,38
CUNDINAMARCA,FOSCA,2022,5483,438,1565,2003,8,11
CUNDINAMARCA,FUNZA,31140,60731,13403,17147,30550,56,534
CUNDINAMARCA,FUQUENE,1646,3913,773,828,1601,12,33
CUNDINAMARCA,FUSAGASUGA,41941,96948,17890,23323,41213,155,573
CUNDINAMARCA,GACHALA,1593,5230,736,793,1529,21,43
CUNDINAMARCA,GACHANCIPA,4691,9080,1718,2816,4534,44,113
CUNDINAMARCA,GACHETA,3193,9217,1070,2036,3106,32,55
CUNDINAMARCA,GAMA,1191,3103,540,609,1149,24,18
CUNDINAMARCA,GIRARDOT,33639,81967,12251,20971,33222,83,334
CUNDINAMARCA,GRANADA,2247,5571,1022,1171,2193,15,39
CUNDINAMARCA,GUACHETA,3566,8587,1424,2003,3427,36,103
CUNDINAMARCA,GUADUAS,8502,22188,3388,4854,8242,79,181
CUNDINAMARCA,GUASCA,4472,10241,1555,2836,4391,21,60
CUNDINAMARCA,GUATAQUI,732,2205,402,307,709,10,13
CUNDINAMARCA,GUATAVITA,2136,4945,811,1279,2090,14,32
CUNDINAMARCA,GUAYABAL DE SIQUIMA,1557,3606,750,770,1520,9,28
CUNDINAMARCA,GUAYABETAL,2028,4467,513,1470,1983,9,36
CUNDINAMARCA,GUTIERREZ,1343,2691,480,831,1311,5,27
CUNDINAMARCA,JERUSALEN,888,2700,474,391,865,16,7
CUNDINAMARCA,JUNIN,1769,5524,694,1023,1717,13,39
CUNDINAMARCA,LA CALERA,9292,20312,4885,4267,9152,26,114
CUNDINAMARCA,LA MESA,8806,23470,4356,4291,8647,36,123
CUNDINAMARCA,LA PALMA,2947,8708,1714,1088,2802,71,74
CUNDINAMARCA,LA PEÑA,2083,5608,514,1498,2012,41,30
CUNDINAMARCA,LA VEGA,5399,12184,2408,2863,5271,17,111
CUNDINAMARCA,LENGUAZAQUE,2636,6966,1011,1532,2543,16,77
CUNDINAMARCA,MACHETA,1825,6109,762,1008,1770,20,35
CUNDINAMARCA,MADRID,28695,54897,10555,17404,27959,95,641
CUNDINAMARCA,MANTA,1739,4110,848,840,1688,17,34
CUNDINAMARCA,MEDINA,3034,6771,1042,1899,2941,39,54
CUNDINAMARCA,MOSQUERA,30102,57821,13047,16521,29568,86,448
CUNDINAMARCA,NARIÑO,748,2535,353,388,741,3,4
CUNDINAMARCA,NEMOCON,4486,8960,1603,2758,4361,35,90
CUNDINAMARCA,NILO,2531,6256,1397,1107,2504,9,18
CUNDINAMARCA,NIMAIMA,1326,3153,540,750,1290,12,24
CUNDINAMARCA,NOCAIMA,2191,5169,1252,886,2138,13,40
CUNDINAMARCA,PACHO,7904,20502,3726,3959,7685,76,143
CUNDINAMARCA,PAIME,1499,4564,766,692,1458,19,22
CUNDINAMARCA,PANDI,1411,4122,741,638,1379,9,23
CUNDINAMARCA,PARATEBUENO (LA NAGUAYA),3066,6946,1227,1749,2976,21,69
CUNDINAMARCA,PASCA,2827,7605,1567,1176,2743,20,64
CUNDINAMARCA,PUERTO SALGAR,4395,12932,1421,2852,4273,28,94
CUNDINAMARCA,PULI,938,2856,437,466,903,11,24
CUNDINAMARCA,QUEBRADANEGRA,1651,3996,480,1137,1617,13,21
CUNDINAMARCA,QUETAME,2352,5408,741,1551,2292,7,53
CUNDINAMARCA,QUIPILE,2095,6135,745,1302,2047,22,26
CUNDINAMARCA,RICAURTE,3795,10455,1688,2076,3764,14,17
CUNDINAMARCA,SAN ANTONIO DEL TEQUENDAMA,3360,8637,1704,1607,3311,16,33
CUNDINAMARCA,SAN BERNARDO,2765,7804,1286,1409,2695,18,52
CUNDINAMARCA,SAN CAYETANO,1364,4319,651,691,1342,13,9
CUNDINAMARCA,SAN FRANCISCO,3321,8389,1180,2099,3279,10,32
CUNDINAMARCA,SAN JUAN DE RIOSECO,3451,8973,1523,1853,3376,34,41
CUNDINAMARCA,SASAIMA,3320,8594,1137,2130,3267,18,35
CUNDINAMARCA,SESQUILE,3880,7764,1488,2266,3754,17,109
CUNDINAMARCA,SIBATE,10578,24060,4132,6222,10354,45,179
CUNDINAMARCA,SILVANIA,6480,16551,3045,3323,6368,44,68
CUNDINAMARCA,SIMIJACA,3367,8608,1179,2097,3276,26,65
CUNDINAMARCA,SOACHA,90969,201745,42449,46767,89216,289,1464
CUNDINAMARCA,SOPO,9243,16285,4579,4500,9079,27,137
CUNDINAMARCA,SUBACHOQUE,6019,11191,1838,4070,5908,21,90
CUNDINAMARCA,SUESCA,4738,9730,1956,2620,4576,24,138
CUNDINAMARCA,SUPATA,1565,4154,574,942,1516,19,30
CUNDINAMARCA,SUSA,2094,5102,1048,949,1997,21,76
CUNDINAMARCA,SUTATAUSA,1615,3746,563,996,1559,21,35
CUNDINAMARCA,TABIO,7386,14659,3249,3983,7232,20,134
CUNDINAMARCA,TAUSA,2705,5720,737,1886,2623,19,63
CUNDINAMARCA,TENA,2308,6197,1238,1028,2266,19,23
CUNDINAMARCA,TENJO,6984,14029,2903,3968,6871,20,93
CUNDINAMARCA,TIBACUY,1508,3706,778,681,1459,29,20
CUNDINAMARCA,TIBIRITA,1064,3018,667,357,1024,31,9
CUNDINAMARCA,TOCAIMA,4680,12896,2351,2249,4600,20,60
CUNDINAMARCA,TOCANCIPA,12199,24441,4971,6865,11836,43,320
CUNDINAMARCA,TOPAIPI,1546,4060,825,656,1481,27,38
CUNDINAMARCA,UBALA,2727,8478,1082,1541,2623,35,69
CUNDINAMARCA,UBAQUE,2182,5660,915,1197,2112,25,45
CUNDINAMARCA,UBATE,13247,30807,4922,7985,12907,66,274
CUNDINAMARCA,UNE,2954,6307,1296,1606,2902,15,37
CUNDINAMARCA,UTICA,1837,4700,616,1184,1800,19,18
CUNDINAMARCA,VENECIA,1213,3562,677,513,1190,8,15
CUNDINAMARCA,VERGARA,2317,7346,1147,1084,2231,45,41
CUNDINAMARCA,VIANI,1441,3867,726,673,1399,14,28
CUNDINAMARCA,VILLAGOMEZ,607,1915,198,375,573,17,17
CUNDINAMARCA,VILLAPINZON,5830,12800,1661,4039,5700,41,89
CUNDINAMARCA,VILLETA,9149,21862,3165,5842,9007,49,93
CUNDINAMARCA,VIOTA,3993,10358,1899,2006,3905,22,66
CUNDINAMARCA,YACOPI,3227,11457,1339,1772,3111,65,51
CUNDINAMARCA,ZIPACON,2066,4091,962,1071,2033,16,17
CUNDINAMARCA,ZIPAQUIRA,42955,82209,20348,21680,42028,120,807
GUAINIA,BARRANCO MINAS,372,1986,298,67,365,2,5
GUAINIA,CACAHUAL,25,338,17,7,24,0,1
GUAINIA,INIRIDA,5194,19789,2663,2436,5099,45,50
GUAINIA,LA GUADALUPE,0,175,0,0,0,0,0
GUAINIA,MAPIRIPANA,49,579,45,4,49,0,0
GUAINIA,MORICHAL (MORICHAL NUEVO),43,179,42,0,42,1,0
GUAINIA,PANA PANA (CAMPO ALEGRE),162,328,116,46,162,0,0
GUAINIA,PUERTO COLOMBIA,106,1207,60,45,105,1,0
GUAINIA,SAN FELIPE,154,835,85,59,144,5,5
GUAVIARE,CALAMAR,1537,5482,1079,417,1496,17,24
GUAVIARE,EL RETORNO,3630,9285,2048,1410,3458,47,125
GUAVIARE,MIRAFLORES,1013,4217,848,142,990,12,11
GUAVIARE,SAN JOSE DEL GUAVIARE,15714,37463,7157,7955,15112,189,413
HUILA,ACEVEDO,6214,18437,1432,4658,6090,45,79
HUILA,AGRADO,2779,6804,875,1849,2724,26,29
HUILA,AIPE,5537,14967,2491,2917,5408,58,71
HUILA,ALGECIRAS,5234,14338,2761,2306,5067,75,92
HUILA,ALTAMIRA,1016,2991,439,561,1000,5,11
HUILA,BARAYA,2307,5983,1206,1057,2263,27,17
HUILA,CAMPOALEGRE,10181,24718,3811,6134,9945,63,173
HUILA,COLOMBIA,2442,6752,952,1431,2383,33,26
HUILA,ELIAS,1355,3169,645,682,1327,14,14
HUILA,GARZON,18902,51641,6356,12101,18457,158,287
HUILA,GIGANTE,7184,18633,2668,4263,6931,65,188
HUILA,GUADALUPE,4581,12391,1331,3132,4463,35,83
HUILA,HOBO,2313,5571,1005,1250,2255,16,42
HUILA,IQUIRA,2901,6862,1110,1727,2837,24,40
HUILA,ISNOS,7723,18179,2041,5426,7467,101,155
HUILA,LA ARGENTINA (PLATA VIEJA),3009,9990,1291,1603,2894,46,69
HUILA,LA PLATA,13985,40433,4475,9191,13666,114,205
HUILA,NATAGA,1770,4497,604,1124,1728,22,20
HUILA,NEIVA,109294,255422,49083,58666,107749,479,1066
HUILA,OPORAPA,3174,7370,847,2246,3093,36,45
HUILA,PAICOL,2175,4738,604,1522,2126,22,27
HUILA,PALERMO,7831,20533,2901,4814,7715,37,79
HUILA,PALESTINA,3120,8509,1146,1876,3022,34,64
HUILA,PITAL,3658,9123,1016,2565,3581,22,55
HUILA,PITALITO,31240,89760,10660,19996,30656,179,405
HUILA,RIVERA,6495,16199,2919,3446,6365,40,90
HUILA,SALADOBLANCO,3447,8635,1420,1936,3356,38,53
HUILA,SAN AGUSTIN,8630,23344,2741,5652,8393,93,144
HUILA,SANTA MARIA,3330,7921,939,2318,3257,26,47
HUILA,SUAZA,3307,11911,1027,2183,3210,41,56
HUILA,TARQUI,4532,11492,1427,3015,4442,31,59
HUILA,TELLO,4139,10814,1899,2120,4019,37,83
HUILA,TERUEL,2584,6481,738,1799,2537,11,36
HUILA,TESALIA (CARNICERIAS),3431,7879,788,2559,3347,24,60
HUILA,TIMANA,6041,15078,1441,4471,5912,64,65
HUILA,VILLAVIEJA,2632,6524,1480,1086,2566,22,44
HUILA,YAGUARA,2983,6750,1137,1802,2939,5,39
LA GUAJIRA,ALBANIA,4139,16633,2333,1655,3988,87,64
LA GUAJIRA,BARRANCAS,6454,23913,4562,1806,6368,13,73
LA GUAJIRA,DIBULLA,4732,20549,3306,1309,4615,49,68
LA GUAJIRA,DISTRACCION,2522,8243,1587,892,2479,12,31
LA GUAJIRA,EL MOLINO,2510,6765,1644,836,2480,9,21
LA GUAJIRA,FONSECA,9006,25836,6402,2463,8865,40,101
LA GUAJIRA,HATONUEVO,4240,14034,2846,1304,4150,31,59
LA GUAJIRA,LA JAGUA DEL PILAR,1196,3839,861,320,1181,0,15
LA GUAJIRA,MAICAO,20773,120312,10766,9563,20329,257,187
LA GUAJIRA,MANAURE,3260,52567,1768,1418,3186,30,44
LA GUAJIRA,RIOHACHA,28290,111639,17613,10092,27705,287,298
LA GUAJIRA,SAN JUAN DEL CESAR,9392,31264,4484,4684,9168,66,158
LA GUAJIRA,URIBIA,3434,101417,1713,1658,3371,19,44
LA GUAJIRA,URUMITA,3225,7997,2042,1141,3183,10,32
LA GUAJIRA,VILLANUEVA,6044,18149,3490,2425,5915,50,79
MAGDALENA,ALGARROBO,2041,9422,1525,467,1992,21,28
MAGDALENA,ARACATACA,1550,26547,962,555,1517,8,25
MAGDALENA,ARIGUANI (EL DIFICIL),5634,21723,3393,2111,5504,79,51
MAGDALENA,CERRO DE SAN ANTONIO,2443,8394,2184,225,2409,11,23
MAGDALENA,CHIVOLO,3619,13108,2827,728,3555,25,39
MAGDALENA,CIENAGA,17804,81617,8629,8670,17299,388,117
MAGDALENA,CONCORDIA,2623,10564,2251,341,2592,15,16
MAGDALENA,EL BANCO,12568,46365,6883,5392,12275,141,152
MAGDALENA,EL PIÑON,3089,13197,2506,529,3035,32,22
MAGDALENA,EL RETEN,2903,12752,1932,800,2732,144,27
MAGDALENA,FUNDACION,9049,51126,4609,4308,8917,35,97
MAGDALENA,GUAMAL,4715,22148,2989,1643,4632,47,36
MAGDALENA,NUEVA GRANADA,3013,14283,1770,1205,2975,20,18
MAGDALENA,PEDRAZA,1926,8926,1340,552,1892,20,14
MAGDALENA,PIJIÑO DEL CARMEN,2505,7813,1557,902,2459,22,24
MAGDALENA,PIVIJAY,7378,28335,6313,933,7246,48,84
MAGDALENA,PLATO,9805,39220,6312,3303,9615,92,98
MAGDALENA,PUEBLOVIEJO,4022,20274,1957,1920,3877,108,37
MAGDALENA,REMOLINO,1943,7037,1716,200,1916,12,15
MAGDALENA,SABANAS DE SAN ANGEL,1868,10380,1090,728,1818,33,17
MAGDALENA,SALAMINA,1313,7454,738,557,1295,8,10
MAGDALENA,SAN SEBASTIAN DE BUENAVISTA,5094,15820,3903,1118,5021,32,41
MAGDALENA,SAN ZENON,2830,7946,2298,497,2795,21,14
MAGDALENA,SANTA ANA,4278,15232,2301,1913,4214,27,37
MAGDALENA,SANTA BARBARA DE PINTO,2156,7978,1737,383,2120,15,21
MAGDALENA,SANTA MARTA,94188,322962,49797,43163,92960,461,767
MAGDALENA,SITIONUEVO,2520,17808,1649,764,2413,88,19
MAGDALENA,TENERIFE,2974,9842,2469,438,2907,28,39
MAGDALENA,ZAPAYAN,2648,7739,2119,489,2608,19,21
MAGDALENA,ZONA BANANERA (SEVILLA),3622,42952,2307,1268,3575,22,25
META,ACACIAS,30284,56070,7978,21513,29491,130,663
META,BARRANCA DE UPIA,1762,4287,613,1104,1717,11,34
META,CABUYARO,1943,4569,718,1182,1900,13,30
META,CASTILLA LA NUEVA,6274,10531,1739,4350,6089,36,149
META,CUBARRAL,2032,4902,602,1385,1987,15,30
META,CUMARAL,7701,15494,2456,5099,7555,31,115
META,EL CALVARIO,686,1707,354,310,664,11,11
META,EL CASTILLO,2086,5374,1247,774,2021,31,34
META,EL DORADO,1371,2794,570,777,1347,11,13
META,FUENTE DE ORO,3815,9442,1556,2153,3709,31,75
META,GRANADA,19968,48638,7007,12415,19422,125,421
META,GUAMAL,5471,10375,1316,4078,5394,15,62
META,LA MACARENA,3108,7900,2238,800,3038,19,51
META,LEJANIAS,3054,7903,1287,1636,2923,39,92
META,MAPIRIPAN,1247,5394,697,505,1202,12,33
META,MESETAS,3045,7585,1843,1126,2969,30,46
META,PUERTO CONCORDIA,2264,5998,1198,974,2172,31,61
META,PUERTO GAITAN,8892,22483,2813,5637,8450,254,188
META,PUERTO LLERAS,2313,6338,997,1251,2248,24,41
META,PUERTO LOPEZ,9355,22839,2564,6618,9182,47,126
META,PUERTO RICO,3098,7957,1443,1553,2996,23,79
META,RESTREPO,6104,14935,2464,3557,6021,23,60
META,SAN CARLOS DE GUAROA,3654,7764,1179,2394,3573,22,59
META,SAN JUAN DE ARAMA,2292,5998,1064,1162,2226,18,48
META,SAN JUANITO,586,1263,309,263,572,6,8
META,SAN MARTIN DE LOS LLANOS,7901,17621,2162,5593,7755,47,99
META,URIBE,2214,4724,2036,140,2176,24,14
META,VILLAVICENCIO,159620,343296,56633,100830,157463,400,1757
META,VISTA HERMOSA,5103,12070,2593,2310,4903,74,126
NARIÑO,ALBAN (SAN JOSE),2984,6438,1244,1610,2854,65,65
NARIÑO,ALDANA,2656,5756,1298,1268,2566,38,52
NARIÑO,ANCUYA,2381,7235,1683,631,2314,32,35
NARIÑO,ARBOLEDA (BERRUECOS),2511,5703,1154,1236,2390,54,67
NARIÑO,BARBACOAS,4361,20859,3159,1063,4222,76,63
NARIÑO,BELEN,2419,5328,1418,934,2352,35,32
NARIÑO,BUESACO,6029,16930,2921,2914,5835,85,109
NARIÑO,CHACHAGUI,3897,9510,2377,1427,3804,43,50
NARIÑO,COLON (GENOVA),2807,6620,1573,1034,2607,73,127
NARIÑO,CONSACA,3541,8497,1969,1434,3403,55,83
NARIÑO,CONTADERO,1987,5544,1036,903,1939,23,25
NARIÑO,CORDOBA,3564,10104,2138,1301,3439,72,53
NARIÑO,CUASPUD (CARLOSAMA),2707,7169,1245,1382,2627,43,37
NARIÑO,CUMBAL,8853,23407,5421,3085,8506,131,216
NARIÑO,CUMBITARA,2462,6203,2119,299,2418,19,25
NARIÑO,EL CHARCO,5221,15747,4599,465,5064,97,60
NARIÑO,EL PEÑOL,2957,5357,2312,554,2866,33,58
NARIÑO,EL ROSARIO,2643,6649,2344,238,2582,19,42
NARIÑO,EL TABLON,4730,10814,2980,1557,4537,84,109
NARIÑO,EL TAMBO,5246,11253,3563,1476,5039,99,108
NARIÑO,FRANCISCO PIZARRO (SALAHONDA),1621,6308,1332,247,1579,15,27
NARIÑO,FUNES,2381,5549,1575,737,2312,38,31
NARIÑO,GUACHUCAL,4581,14068,2511,1938,4449,54,78
NARIÑO,GUAITARILLA,3153,10811,2255,800,3055,51,47
NARIÑO,GUALMATAN,2383,5077,1404,932,2336,15,32
NARIÑO,ILES,2369,6900,1430,857,2287,37,45
NARIÑO,IMUES,2129,6314,1156,912,2068,33,28
NARIÑO,IPIALES,32826,92217,15864,15842,31706,617,503
NARIÑO,LA CRUZ,5690,13571,2846,2652,5498,105,87
NARIÑO,LA FLORIDA,3227,8949,2292,848,3140,48,39
NARIÑO,LA LLANADA,1490,3376,996,400,1396,36,58
NARIÑO,LA TOLA,1975,4996,1710,234,1944,8,23
NARIÑO,LA UNION,7736,21535,3200,4247,7447,125,164
NARIÑO,LEIVA,2973,7254,2605,277,2882,47,44
NARIÑO,LINARES,3632,8485,3047,452,3499,69,64
NARIÑO,LOS ANDES (SOTOMAYOR),3279,7132,2426,723,3149,70,60
NARIÑO,MAGUI (PAYAN),2344,6221,2129,157,2286,24,34
NARIÑO,MALLAMA (PIEDRANCHA),1897,5984,1154,675,1829,30,38
NARIÑO,MOSQUERA,2234,5897,1975,224,2199,13,22
NARIÑO,NARIÑO,1673,4120,988,649,1637,15,21
NARIÑO,OLAYA HERRERA,3274,13572,2632,572,3204,34,36
NARIÑO,OSPINA,1803,5668,1102,637,1739,38,26
NARIÑO,PASTO,114341,279784,70354,41981,112335,501,1505
NARIÑO,POLICARPA,4257,9537,3690,461,4151,55,51
NARIÑO,POTOSI,3510,9425,1590,1809,3399,48,63
NARIÑO,PROVIDENCIA,1890,4259,1586,228,1814,50,26
NARIÑO,PUERRES,3292,7410,2191,997,3188,34,70
NARIÑO,PUPIALES,6033,14600,2820,3010,5830,63,140
NARIÑO,RICAURTE,3048,13557,1947,974,2921,79,48
NARIÑO,ROBERTO PAYAN (SAN JOSE),2365,8368,2135,198,2333,10,22
NARIÑO,SAMANIEGO,8666,22140,7072,1359,8431,69,166
NARIÑO,SAN BERNARDO,3171,6072,1892,1172,3064,57,50
NARIÑO,SAN LORENZO,4779,12768,2812,1711,4523,98,158
NARIÑO,SAN PABLO,3759,11317,2353,1221,3574,92,93
NARIÑO,SAN PEDRO DE CARTAGO,2148,5234,1058,989,2047,49,52
NARIÑO,SANDONA,6773,15906,4208,2346,6554,107,112
NARIÑO,SANTA BARBARA (ISCUANDE),2471,6997,2229,206,2435,12,24
NARIÑO,SANTACRUZ (GUACHAVES),1907,6875,1301,513,1814,54,39
NARIÑO,SAPUYES,1857,5628,1089,715,1804,21,32
NARIÑO,TAMINANGO,5014,13578,3792,1028,4820,100,94
NARIÑO,TANGUA,3198,9879,1659,1467,3126,26,46
NARIÑO,TUMACO,34266,121788,23534,9520,33054,503,709
NARIÑO,TUQUERRES,10320,34090,6384,3521,9905,147,268
NARIÑO,YACUANQUER,3352,8133,2169,1034,3203,61,88
NORTE DE SAN,ABREGO,6377,21133,2095,4149,6244,56,77
NORTE DE SAN,ARBOLEDAS,3096,6826,907,2078,2985,53,58
NORTE DE SAN,BOCHALEMA,2941,6046,1080,1786,2866,25,50
NORTE DE SAN,BUCARASICA,1498,4108,413,985,1398,30,70
NORTE DE SAN,CACHIRA,2634,6959,531,2060,2591,15,28
NORTE DE SAN,CACOTA,873,2156,413,432,845,4,24
NORTE DE SAN,CHINACOTA,5453,11426,1983,3351,5334,29,90
NORTE DE SAN,CHITAGA,2908,7562,1056,1729,2785,45,78
NORTE DE SAN,CONVENCION,3732,14827,2101,1411,3512,83,137
NORTE DE SAN,CUCUTA,245727,542712,83572,157742,241314,1325,3088
NORTE DE SAN,CUCUTILLA,2939,6168,938,1850,2788,79,72
NORTE DE SAN,DURANIA,1933,4279,1003,885,1888,13,32
NORTE DE SAN,EL CARMEN,3059,10030,1515,1388,2903,38,118
NORTE DE SAN,EL TARRA,3222,11167,2827,262,3089,41,92
NORTE DE SAN,EL ZULIA,8042,20243,2770,5024,7794,67,181
NORTE DE SAN,GRAMALOTE,1946,4850,632,1253,1885,23,38
NORTE DE SAN,HACARI,1839,6906,1562,184,1746,34,59
NORTE DE SAN,HERRAN,1192,3574,377,769,1146,18,28
NORTE DE SAN,LA ESPERANZA,3060,8292,1021,1941,2962,43,55
NORTE DE SAN,LA PLAYA,1574,6626,734,769,1503,32,39
NORTE DE SAN,LABATECA,1709,4905,877,782,1659,18,32
NORTE DE SAN,LOS PATIOS,28831,78165,7986,20494,28480,58,293
NORTE DE SAN,LOURDES,1299,3214,317,904,1221,25,53
NORTE DE SAN,MUTISCUA,1134,2664,499,605,1104,9,21
NORTE DE SAN,OCAÑA,27977,76057,10753,16720,27473,126,378
NORTE DE SAN,PAMPLONA,18963,43064,6506,12079,18585,85,293
NORTE DE SAN,PAMPLONITA,1842,3796,577,1178,1755,41,46
NORTE DE SAN,PUERTO SANTANDER,2236,13119,591,1607,2198,10,28
NORTE DE SAN,RAGONVALIA,1728,6440,422,1266,1688,17,23
NORTE DE SAN,SALAZAR,3156,7487,974,2029,3003,47,106
NORTE DE SAN,SAN CALIXTO,2607,6979,2393,121,2514,25,68
NORTE DE SAN,SAN CAYETANO,2244,6918,694,1509,2203,8,33
NORTE DE SAN,SANTIAGO,1459,3311,642,779,1421,8,30
NORTE DE SAN,SARDINATA,5913,17063,1991,3725,5716,78,119
NORTE DE SAN,SILOS,1392,3968,259,1100,1359,15,18
NORTE DE SAN,TEORAMA,2953,9725,2429,380,2809,45,99
NORTE DE SAN,TIBU,9182,31208,5847,3008,8855,99,228
NORTE DE SAN,TOLEDO,4310,12026,1311,2803,4114,61,135
NORTE DE SAN,VILLA CARO,1261,3727,297,920,1217,21,23
NORTE DE SAN,VILLA DEL ROSARIO,26839,79404,6360,20126,26486,78,275
PUTUMAYO,COLON,1912,4244,1072,804,1876,17,19
PUTUMAYO,MOCOA,13066,35245,7718,5105,12823,84,159
PUTUMAYO,ORITO,8226,25937,6165,1820,7985,86,155
PUTUMAYO,PUERTO ASIS,11158,41742,6267,4539,10806,145,207
PUTUMAYO,PUERTO CAICEDO,2878,8922,1947,802,2749,50,79
PUTUMAYO,PUERTO GUZMAN,3106,10561,2176,832,3008,41,57
PUTUMAYO,PUERTO LEGUIZAMO,3794,14436,2031,1695,3726,29,39
PUTUMAYO,SAN FRANCISCO,1998,4710,1069,849,1918,35,45
PUTUMAYO,SAN MIGUEL (LA DORADA),3487,11779,2816,559,3375,56,56
PUTUMAYO,SANTIAGO,2320,5929,1359,881,2240,32,48
PUTUMAYO,SIBUNDOY,4434,10309,2499,1783,4282,75,77
PUTUMAYO,VALLE DEL GUAMUEZ (LA HORMIGA),7917,23170,6655,1079,7734,78,105
PUTUMAYO,VILLAGARZON,5794,15777,2869,2757,5626,54,114
QUINDIO,ARMENIA,105002,247873,43835,59049,102884,913,1205
QUINDIO,BUENAVISTA,1028,2857,441,564,1005,6,17
QUINDIO,CALARCA,23963,58297,8767,14557,23324,262,377
QUINDIO,CIRCASIA,9364,21943,3343,5837,9180,53,131
QUINDIO,CORDOBA,1960,5090,872,1028,1900,25,35
QUINDIO,FILANDIA,4256,10343,1522,2627,4149,39,68
QUINDIO,GENOVA,2810,7384,987,1739,2726,29,55
QUINDIO,LA TEBAIDA,11156,27501,4032,6822,10854,98,204
QUINDIO,MONTENEGRO,11873,33103,3398,8140,11538,108,227
QUINDIO,PIJAO,2385,6022,815,1523,2338,13,34
QUINDIO,QUIMBAYA,12049,29792,4528,7156,11684,211,154
QUINDIO,SALENTO,2578,5762,853,1666,2519,27,32
RISARALDA,APIA,3800,10487,1265,2404,3669,47,84
RISARALDA,BALBOA,2032,5565,891,1074,1965,23,44
RISARALDA,BELEN DE UMBRIA,7133,21462,2639,4278,6917,73,143
RISARALDA,DOSQUEBRADAS,67458,154003,28055,37995,66050,364,1044
RISARALDA,GUATICA,3795,10351,1240,2443,3683,45,67
RISARALDA,LA CELIA,2457,6500,903,1462,2365,33,59
RISARALDA,LA VIRGINIA,12411,31403,4852,7229,12081,120,210
RISARALDA,MARSELLA,5602,15561,2067,3350,5417,88,97
RISARALDA,MISTRATO,3765,11096,1926,1716,3642,58,65
RISARALDA,PEREIRA,165775,393135,75063,87598,162661,836,2278
RISARALDA,PUEBLO RICO,2851,9245,1720,1008,2728,76,47
RISARALDA,QUINCHIA,8321,19821,4144,3734,7878,184,259
RISARALDA,SANTA ROSA DE CABAL,25498,59393,9970,14826,24796,184,518
RISARALDA,SANTUARIO,3775,12258,1473,2113,3586,70,119
SAN ANDRES,PROVIDENCIA,1210,4017,974,216,1190,16,4
SAN ANDRES,SAN ANDRES,8466,43864,4301,4097,8398,36,32
SANTANDER,AGUADA,361,1524,165,182,347,8,6
SANTANDER,ALBANIA,1200,3290,656,508,1164,21,15
SANTANDER,ARATOCA,2680,6477,1328,1251,2579,50,51
SANTANDER,BARBOSA,9191,24199,4413,4552,8965,64,162
SANTANDER,BARICHARA,2608,6261,1452,1085,2537,20,51
SANTANDER,BARRANCABERMEJA,77255,167609,38260,37440,75700,402,1153
SANTANDER,BETULIA,1503,3989,620,833,1453,11,39
SANTANDER,BOLIVAR,2845,8280,1400,1271,2671,76,98
SANTANDER,BUCARAMANGA,225567,495063,100143,122985,223128,457,1982
SANTANDER,CABRERA,695,1644,446,232,678,7,10
SANTANDER,CALIFORNIA,708,1676,152,532,684,5,19
SANTANDER,CAPITANEJO,1840,4870,672,1103,1775,33,32
SANTANDER,CARCASI,1651,3656,509,1058,1567,23,61
SANTANDER,CEPITA,943,1771,584,318,902,16,25
SANTANDER,CERRITO,2177,4803,949,1109,2058,37,82
SANTANDER,CHARALA,3582,9583,2148,1353,3501,28,53
SANTANDER,CHARTA,1339,3218,372,941,1313,8,18
SANTANDER,CHIMA,913,2338,558,299,857,25,31
SANTANDER,CHIPATA,989,4142,687,273,960,17,12
SANTANDER,CIMITARRA,9548,28154,3718,5480,9198,79,271
SANTANDER,CONCEPCION,1884,4893,642,1015,1657,165,62
SANTANDER,CONFINES,865,2348,321,524,845,6,14
SANTANDER,CONTRATACION,1371,2920,762,554,1316,25,30
SANTANDER,COROMORO,1594,4141,795,691,1486,41,67
SANTANDER,CURITI,3378,8217,1526,1741,3267,35,76
SANTANDER,EL CARMEN,4458,10715,1138,3114,4252,44,162
SANTANDER,EL GUACAMAYO,813,1590,539,234,773,17,23
SANTANDER,EL PEÑON,1328,3339,620,631,1251,32,45
SANTANDER,EL PLAYON,4361,11556,1157,3041,4198,59,104
SANTANDER,ENCINO,692,2123,405,244,649,17,26
SANTANDER,ENCISO,1345,3267,595,702,1297,18,30
SANTANDER,FLORIAN,1703,5159,1115,550,1665,16,22
SANTANDER,FLORIDABLANCA,87866,178805,36189,50640,86829,167,870
SANTANDER,GALAN,1082,2536,434,603,1037,14,31
SANTANDER,GAMBITA,1135,3239,603,497,1100,16,19
SANTANDER,GIRON,45814,105643,17099,28052,45151,114,549
SANTANDER,GUACA,2052,5140,766,1215,1981,33,38
SANTANDER,GUADALUPE,1567,4334,607,908,1515,22,30
SANTANDER,GUAPOTA,774,1834,381,357,738,9,27
SANTANDER,GUAVATA,1345,4470,808,495,1303,14,28
SANTANDER,GUEPSA,1462,4173,885,548,1433,9,20
SANTANDER,HATO,817,1825,464,310,774,24,19
SANTANDER,JESUS MARIA,1055,3248,645,375,1020,16,19
SANTANDER,JORDAN,399,1107,194,191,385,11,3
SANTANDER,LA BELLEZA,2250,5353,741,1464,2205,17,28
SANTANDER,LA PAZ,1217,4139,681,490,1171,17,29
SANTANDER,LANDAZURI,3055,9356,1484,1336,2820,62,173
SANTANDER,LEBRIJA,12831,29381,3857,8738,12595,61,175
SANTANDER,LOS SANTOS,4109,8529,1643,2265,3908,35,166
SANTANDER,MACARAVITA,840,2244,456,347,803,16,21
SANTANDER,MALAGA,6841,15663,2538,4086,6624,39,178
SANTANDER,MATANZA,2256,4853,866,1334,2200,17,39
SANTANDER,MOGOTES,2854,7512,1165,1501,2666,60,128
SANTANDER,MOLAGAVITA,1433,3592,531,830,1361,34,38
SANTANDER,OCAMONTE,1670,3773,1129,489,1618,17,35
SANTANDER,OIBA,3582,8450,1543,1931,3474,29,79
SANTANDER,ONZAGA,1276,3795,634,554,1188,47,41
SANTANDER,PALMAR,594,1353,397,183,580,8,6
SANTANDER,PALMAS DEL SOCORRO,1013,2453,526,456,982,11,20
SANTANDER,PARAMO,1586,3201,791,754,1545,8,33
SANTANDER,PIEDECUESTA,49041,100462,19145,28817,47962,340,739
SANTANDER,PINCHOTE,1357,3181,742,577,1319,13,25
SANTANDER,PUENTE NACIONAL,4456,12869,2492,1857,4349,35,72
SANTANDER,PUERTO PARRA,1545,5414,487,1026,1513,15,17
SANTANDER,PUERTO WILCHES,8619,22860,4098,4317,8415,42,162
SANTANDER,RIONEGRO,8296,22075,2675,5347,8022,95,179
SANTANDER,SABANA DE TORRES,7916,20581,2386,5347,7733,59,124
SANTANDER,SAN ANDRES,3085,7084,1642,1312,2954,52,79
SANTANDER,SAN BENITO,880,2989,584,279,863,9,8
SANTANDER,SAN GIL,17462,40079,8574,8416,16990,215,257
SANTANDER,SAN JOAQUIN,739,2219,429,264,693,21,25
SANTANDER,SAN JOSE DE MIRANDA,1818,3917,578,1187,1765,28,25
SANTANDER,SAN MIGUEL,825,2161,423,356,779,22,24
SANTANDER,SAN VICENTE DE CHUCURI,9173,24555,3604,5237,8841,80,252
SANTANDER,SANTA BARBARA,734,1995,255,453,708,11,15
SANTANDER,SANTA HELENA DEL OPON,1113,3101,396,633,1029,19,65
SANTANDER,SIMACOTA,2290,5898,1237,970,2207,17,66
SANTANDER,SOCORRO,9556,23774,4348,5049,9397,36,123
SANTANDER,SUAITA,2678,8256,1395,1189,2584,29,65
SANTANDER,SUCRE,1858,5837,698,1104,1802,28,28
SANTANDER,SURATA,1343,3016,478,805,1283,20,40
SANTANDER,TONA,2039,4950,808,1149,1957,16,66
SANTANDER,VALLE DE SAN JOSE,1902,4637,935,904,1839,18,45
SANTANDER,VELEZ,6193,16435,3254,2742,5996,37,160
SANTANDER,VETAS,580,1466,92,476,568,2,10
SANTANDER,VILLANUEVA,2389,6336,912,1427,2339,16,34
SANTANDER,ZAPATOCA,2620,7366,984,1563,2547,22,51
SUCRE,BUENAVISTA,3250,9619,2187,993,3180,48,22
SUCRE,CAIMITO,2814,8757,2126,623,2749,41,24
SUCRE,CHALAN,1394,4403,869,466,1335,40,19
SUCRE,COLOSO (RICAURTE),2374,6755,1628,693,2321,27,26
SUCRE,COROZAL,18206,45886,10907,6973,17880,120,206
SUCRE,COVEÑAS,3898,10921,1918,1915,3833,24,41
SUCRE,EL ROBLE,2912,7694,2238,633,2871,19,22
SUCRE,GALERAS (NUEVA GRANADA),5332,15770,2181,3039,5220,61,51
SUCRE,GUARANDA,3584,12792,1811,1701,3512,24,48
SUCRE,LA UNION,2983,9408,2329,599,2928,37,18
SUCRE,LOS PALMITOS,7661,17591,5779,1751,7530,65,66
SUCRE,MAJAGUAL,6929,26077,3935,2857,6792,85,52
SUCRE,MORROA,5222,12813,3322,1753,5075,46,101
SUCRE,OVEJAS,7470,20135,5328,2019,7347,65,58
SUCRE,PALMITO,3394,9642,2323,1011,3334,31,29
SUCRE,SAMPUES,11708,30974,6816,4596,11412,126,170
SUCRE,SAN BENITO ABAD,5485,18505,3460,1917,5377,62,46
SUCRE,SAN JUAN DE BETULIA (BETULIA),4534,11225,3185,1282,4467,28,39
SUCRE,SAN MARCOS,11381,42745,7058,4036,11094,122,165
SUCRE,SAN ONOFRE,10458,40959,7973,2247,10220,117,121
SUCRE,SAN PEDRO,5895,16284,3759,2036,5795,62,38
SUCRE,SINCE,9157,25579,5470,3493,8963,82,112
SUCRE,SINCELEJO,70389,195898,37461,31435,68896,722,771
SUCRE,SUCRE,5670,20688,3100,2459,5559,59,52
SUCRE,TOLU,7870,22816,5427,2300,7727,54,89
SUCRE,TOLUVIEJO,7424,17811,5227,2060,7287,74,63
TOLIMA,ALPUJARRA,1517,3725,452,1005,1457,14,46
TOLIMA,ALVARADO,2787,8422,1312,1415,2727,24,36
TOLIMA,AMBALEMA,2403,6922,1216,1126,2342,14,47
TOLIMA,ANZOATEGUI,2362,7462,693,1576,2269,51,42
TOLIMA,ARMERO (GUAYABAL),3568,10172,1794,1676,3470,30,68
TOLIMA,ATACO,5252,14957,1658,3451,5109,75,68
TOLIMA,CAJAMARCA,6046,16190,1823,4084,5907,54,85
TOLIMA,CARMEN DE APICALA,3506,8453,1218,2242,3460,12,34
TOLIMA,CASABIANCA,1926,4940,922,953,1875,29,22
TOLIMA,CHAPARRAL,12516,38101,5476,6694,12170,174,172
TOLIMA,COELLO,2701,7709,1488,1157,2645,22,34
TOLIMA,COYAIMA,5685,17192,3404,2081,5485,119,81
TOLIMA,CUNDAY,2648,7208,1075,1516,2591,26,31
TOLIMA,DOLORES,2759,6729,1109,1563,2672,35,52
TOLIMA,ESPINAL,23446,58148,8388,14623,23011,111,324
TOLIMA,FALAN,2230,5702,1147,995,2142,36,52
TOLIMA,FLANDES,6693,17194,2373,4194,6567,38,88
TOLIMA,FRESNO,8566,26101,2741,5542,8283,100,183
TOLIMA,GUAMO,9014,25766,3042,5783,8825,75,114
TOLIMA,HERVEO,1932,5922,724,1128,1852,40,40
TOLIMA,HONDA,8549,23027,3549,4788,8337,62,150
TOLIMA,IBAGUE,182499,392554,70780,108879,179659,656,2184
TOLIMA,ICONONZO,2912,8395,1498,1335,2833,30,49
TOLIMA,LERIDA,5665,15269,2748,2812,5560,28,77
TOLIMA,LIBANO,10767,32895,5158,5238,10396,145,226
TOLIMA,MARIQUITA,11144,28817,4570,6277,10847,80,217
TOLIMA,MELGAR,10942,27553,3102,7663,10765,47,130
TOLIMA,MURILLO,1169,3782,409,690,1099,14,56
TOLIMA,NATAGAIMA,5420,15411,2970,2331,5301,41,78
TOLIMA,ORTEGA,8505,23729,3247,4872,8119,159,227
TOLIMA,PALOCABILDO,2488,7468,1003,1412,2415,24,49
TOLIMA,PIEDRAS,1968,5387,974,959,1933,10,25
TOLIMA,PLANADAS,6205,19662,2818,3081,5899,108,198
TOLIMA,PRADO,2999,7933,1121,1799,2920,36,43
TOLIMA,PURIFICACION,8339,20186,4045,4139,8184,50,105
TOLIMA,RIOBLANCO,4778,16033,2209,2317,4526,133,119
TOLIMA,RONCESVALLES,1566,4175,768,728,1496,22,48
TOLIMA,ROVIRA,6272,19506,1776,4287,6063,57,152
TOLIMA,SALDAÑA,4492,12416,1463,2954,4417,22,53
TOLIMA,SAN ANTONIO,4044,10013,1097,2770,3867,83,94
TOLIMA,SAN LUIS,4344,10802,1638,2595,4233,54,57
TOLIMA,SANTA ISABEL,1791,5802,485,1256,1741,19,31
TOLIMA,SUAREZ,1813,4386,700,1095,1795,3,15
TOLIMA,VALLE DE SAN JUAN,1500,4942,673,789,1462,12,26
TOLIMA,VENADILLO,4488,11721,1929,2478,4407,29,52
TOLIMA,VILLAHERMOSA,2419,7181,605,1732,2337,43,39
TOLIMA,VILLARRICA,1793,5204,671,1070,1741,10,42
VALLE,ALCALA,3800,11192,1804,1886,3690,41,69
VALLE,ANDALUCIA,6865,19548,3505,3219,6724,40,101
VALLE,ANSERMANUEVO,5405,19269,1667,3609,5276,49,80
VALLE,ARGELIA,1955,6426,923,983,1906,19,30
VALLE,BOLIVAR,4964,13389,2065,2759,4824,65,75
VALLE,BUENAVENTURA,62389,219150,42565,17670,60235,629,1525
VALLE,BUGA,42281,100078,20956,20572,41528,202,551
VALLE,BUGALAGRANDE,7101,19020,3977,2934,6911,54,136
VALLE,CAICEDONIA,10321,28321,3886,6106,9992,143,186
VALLE,CALI,596245,1637938,319949,269502,589451,2298,4496
VALLE,CALIMA (DARIEN),4705,13908,2238,2349,4587,41,77
VALLE,CANDELARIA,23999,68548,10898,12525,23423,136,440
VALLE,CARTAGO,39722,111785,14845,24101,38946,222,554
VALLE,DAGUA,10754,35005,4666,5858,10524,80,150
VALLE,EL AGUILA,2896,8127,871,1949,2820,20,56
VALLE,EL CAIRO,1935,6723,932,919,1851,52,32
VALLE,EL CERRITO,18476,51868,9380,8732,18112,101,263
VALLE,EL DOVIO,3042,9808,972,1987,2959,32,51
VALLE,FLORIDA,18826,50135,10354,7906,18260,219,347
VALLE,GINEBRA,6619,16309,3182,3263,6445,75,99
VALLE,GUACARI,10586,27420,5786,4555,10341,61,184
VALLE,JAMUNDI,34404,96350,18060,15665,33725,161,518
VALLE,LA CUMBRE,4132,12758,2037,2022,4059,29,44
VALLE,LA UNION,10429,26489,2792,7386,10178,81,170
VALLE,LA VICTORIA,4260,11609,1930,2234,4164,41,55
VALLE,OBANDO,3657,11185,1579,1970,3549,27,81
VALLE,PALMIRA,101380,261731,54278,45431,99709,509,1162
VALLE,PRADERA,15215,39766,7574,7263,14837,120,258
VALLE,RESTREPO,4447,14911,1777,2574,4351,38,58
VALLE,RIOFRIO,5310,15859,2103,3065,5168,44,98
VALLE,ROLDANILLO,11174,28313,4631,6372,11003,56,115
VALLE,SAN PEDRO,5506,14680,2708,2689,5397,34,75
VALLE,SEVILLA,13312,37835,6589,6231,12820,157,335
VALLE,TORO,3926,12667,1383,2422,3805,44,77
VALLE,TRUJILLO,5401,15793,1960,3296,5256,60,85
VALLE,TULUA,62052,157134,27738,32877,60615,436,1001
VALLE,ULLOA,1674,4636,909,712,1621,25,28
VALLE,VERSALLES,2686,7989,963,1650,2613,35,38
VALLE,VIJES,3437,10404,1812,1554,3366,36,35
VALLE,YOTOCO,5060,14310,2358,2608,4966,33,61
VALLE,YUMBO,34988,96839,18095,16252,34347,171,470
VALLE,ZARZAL,13542,36664,6632,6580,13212,67,263
VAUPES,BUENOS AIRES (PACOA),190,1080,170,16,186,1,3
VAUPES,CARURU,465,1721,382,76,458,0,7
VAUPES,MITU,3627,15576,2705,872,3577,20,30
VAUPES,MORICHAL (PAPUNAGUA),19,109,18,1,19,0,0
VAUPES,TARAIRA,345,1377,243,65,308,36,1
VAUPES,YAVARATE,316,1035,278,37,315,1,0
VICHADA,CUMARIBO,3763,19420,2717,952,3669,42,52
VICHADA,LA PRIMAVERA,2504,7267,661,1787,2448,23,33
VICHADA,PUERTO CARREÑO,4820,17433,2185,2549,4734,24,62
VICHADA,SANTA ROSALIA,1284,3013,576,689,1265,6,13
